NO ./images/NO.xpm
SO ./images/SO.xpm
WE ./images/WE.xpm
EA ./images/EA.xpm

F 50,50,50
C 100,150,240

111111111111
1000000000001
100N000000001
1000000000001
1000011100001
1000010000001
1000011100001
1000000000001
1111111111111
