NO ./images/SO.xpm
SO ./images/SO.xpm
WE ./images/SO.xpm
EA ./images/SO.xpm

F 0,0,0
C 255,255,255

1111111111111
1000000000001
100N000000001
1000000000001
1000011100001
1000010000001
1000011100001
1000000000001
1111111111111
